11111111111
10000000001
10201000001
10002000001
10000010001
10000020001
10000000001
10000001001
10000020001
11111111111
