NO texture/wood.xpm



SO texture/redbrick.xpm
WE     texture/greystone.xpm


EA texture/colorstone.xpm

S texture/barrel.xpm



R 800     600


F 120,130,180



C        213,211,123

     11111111111
     10100000001
1111110000111111
11112000001
   1000000111111
11110200W00000011
1001000000000000111
1111111000011100001
      1100011111111
       11111111111
